R 768 768
NXT ./terran.cub

NO ../textures/pn.xpm
SO ../textures/ps.xpm
WE ../textures/pw.xpm
EA ../textures/pe.xpm

S ../textures/pdragun.xpm ../textures/c14rifle2562.xpm ../textures/medic.xpm ../textures/bullets.xpm ../textures/pinter.xpm ../textures/pcarri.xpm ../textures/tdrop.xpm ../textures/riflehud1.xpm
F ../textures/pfloor.xpm
C ../textures/pceil.xpm


                                                                                                   1111111
                                                                                               11111000001
                                                                                             11000000000011
                                                                                         111110000000000001
                                                                                         1000000000000000011
                                                                                      111100000000000000000111
                                                                               111111110000000000000000000001
                                                                            1111000000000000001110000000000001
                                          111111111111111111111111111111111111111111111111111110111111111101111111
                                         11010001010010000000000000000000000000000001000000000101000000100000000011
                                     11111000010001000100011100111110000111111101000100101111110111111010010111111111
                                    1111100111111100100100001001000000000000100010101011010000000000010000100000001111
                                    1111000111111110100111100001000111110001111110000000010111111110110001110000001
                                       111000000000010000000000100000001000000000000100000000000000000000111000001
           1111111111111111111111111111111111111111111111111111111111111111111111111111111111111111111111111111111111111
        11113000000000000211400000000000204010000400000000000000000000000210001001002011100000020100000000002222210400011111
      11100211111111110011011100000111111110010000100001000000011110200014010001000041000002001011100100000145345110002000001
    11100011000000000100021000022012000001001400110000142000111041110001001000111111111111000010400110002001453451107000111111111
 111100011110111110001001110211000100000000010011001100000001000000110010010000000000402010002011111001000014511000070000700000111111
 1E0100010000000210141000010001100100011110000110001100000020010200110001010001000000000010000111110001000111110000707007070000600001
 100002014500000010001010010400110100001110001104001100000010000000110020120011111111100010000111100001100010000020070700700007002081
 111100011111111110011010010000011100100010011020001111100000002011100001000110000110000010020000000020000100002000707000000000111111
    11100000002400001000001200000110011200001111111111110000200011100020001110000000000000000001111110000012211002000200111111111
      1110000011100010000011111101100011001000000001140020001111111111100000000110000111000000014444100000022011000200040001
        11114000000000020000000000100000001000000001120000000000000002000000000100000100000200000000000000000001100000011111
           1111111111111111111111111111111111111111111111111111111111111111111111111111111111111111111111111111111111111
                                        111000001000000100000000000000000000000000000000000000000000100000000000011
                                    1111000000001000000100111111011111111111110000111111000000000000100000111111111
                                    1111100000001011111100100001010000010000010011100001000000000000000000000000001111
                                     11111100000000000000010000101000001000001000010000000000111111111110011000001111
                                         11000001000000000100000000000010000000000100001000001010000000000101000011
                                          111111111111111111111111111111111110000010000100000100100000000100011111
                                                                            1111001000010000010001000111100001
                                                                               1111111100000010000100001000001
                                                                                      111100010000010001000111
                                                                                          100100000100010001
                                                                                          111110000100010001
                                                                                              11000000000011
                                                                                               111110000011
                                                                                                   1111111
