1111111111
1E000001C1
11110C0001
1C01000011
1100011P11
1111111111
