R 768 768
NXT ./zerg.cub

NO ../textures/tn.xpm
SO ../textures/ts.xpm
WE ../textures/tw.xpm
EA ../textures/te.xpm

S ../textures/tmarin.xpm ../textures/c14rifle2562.xpm ../textures/medic.xpm ../textures/bullets.xpm ../textures/tscv.xpm ../textures/tghost.xpm  ../textures/tdrop.xpm ../textures/riflehud1.xpm 
F ../textures/tfloor.xpm
C ../textures/tceil.xpm

                                                                                                   1111111
                                                                                               11111000001
                                                                                             11000000000011
                                                                                         111110000000000001
                                                                                         1000000000000000011
                                                                                      111100000000000000000111
                                                                               111111110000000000000000000001
                                                                            1111000000000000001110000000000001
                                          111111111111111111111111111111111111111111111111111110111111111101111111
                                         11010001010010000000000000000000000000000001000000000101000000100000000011
                                     11111000010001000100011100111110000111111101000100101111110111111010010111111111
                                    1111100111111100100100001001000000000000100010101011010000000000010000100000001111
                                    1111000111111110100111100001000111110001111110000000010111111110110001110000001
                                       111000000000010000000000100000001000000000000100000000000000000000111000001
           1111111111111111111111111111111111111111111111111111111111111111111111111111111111111111111111111111111111111
        11110000000000000011000000000000000010000000000000000000000000000010001001000011100000000100000000000000010000011111
      1110001111111111000011100000111111110010000100001000000011110000010010001000001000000001011100100000010000110000000001
    111000110000000001000010000000100000010010001100001000001110011100010010001111111111110000100001100000010000011000000111111111
 111100011110111110001000010011000100000000010011001100000001000000110010010000000000000010000011111001000010011000000000000000111111
 1001000100000000101010000100011001000111100001100011000000000100001100010100010000000000100001111100010001111100000000000000000000011
 1000000100000000100010100100001101000011100011000011000000100000001100001000111111111000100001111000011000100000000000000000000000001
 1111000111111111100110100100000111001000100110000011111000000000111000010001100001100000100000000000000001000000000000000000001111111
    1110000000000000100000100000011001100000111111111111000000001110000000111000000000000000000111111000001001100000000111111111
      1110000011100010000011111101100011001000000001100000001111111111100000000110000111000000010000100000000011000000000001
        11110000000000000000000000100000001000000001100000000000000000000000000100000100000000000000000000000001100000011111
           1111111111111111111111111111111111111111111111111111111111111111111111111111111111111111111111111111111111111
                                       1111000001000004100000000000000000700020000000000007770000000100000077744411
                                    1111E01004001000003100111111011111111111110000111111007270000000100000111111111
                                    1111000000001011111100100001010200010000010011100001007770000000000000000000001111
                                     11111100000000000000010450101000001040001000010402000000111111111110011000001111
                                         11000001000700000100000000000010020000000100001000001410000350000181000011
                                          111111111111111111111111111111111110000010020100000144120000000106011111                                                        
                                                                            1111001000010000014451000111100001
                                                                               1111111100000014455100071020021
                                                                                      111100014455310001000111
                                                                                          100144553100010221
                                                                                          111114553100710001
                                                                                              11222000000011
                                                                                               111117000011
                                                                                                   1111111                                    
