R 768 768
NXT ./protoss.cub

NO ../textures/zn.xpm
SO ../textures/zs.xpm
WE ../textures/zw.xpm
EA ../textures/ze.xpm

S ../textures/zhydra.xpm ../textures/c14rifle2562.xpm ../textures/medic.xpm ../textures/bullets.xpm ../textures/zegg.xpm ../textures/zmutal.xpm ../textures/tdrop.xpm ../textures/riflehud1.xpm
F ../textures/zfloor.xpm
C ../textures/zceil.xpm


                                                                                                   1111111
                                                                                               11111008001
                                                                                             11000070060011
                                                                                         1111100207000707001
                                                                                         1000070000070002011
                                                                                      111102000002000200200111
                                                                               111111110000000070000200011001
                                                                            1111000000000002001110000000007001
                                          111111111111111111111111111111111111111111111111111110111111111121111111
                                         1171001510013401110000000070700000700200001000002444107002000127002244411
                                     11111000000471001100411120111110000111111171002100101111110111111010012111111111
                                    111E010111111170000100001001000000000000140010101011210000020000010070123453541111
                                    1110000111111110100111100021000111110001111110000700010111111110110701113453541
                                      11110000000000100000000001000000010000200007001000000000000200000700111453541
           1111111111111111111111111111111111111111111111111111111111111111111111111111111111111111111111111111111111111
        11110000000000000011000000000000000010000000000000000000000000000010001001000011100000000100000000000000010000011111
      1110001111111111000011100000111111110010000100001000000011110000010010001000001000000001011100100000010000110000000001
    111000110000000001000010000000100000010010001100001000001110011100010010001111111111110000100001100000010000011000000111111111
 111100011110111110001000010011000100000000010011001100000001000000110010010000000000000010000011111001000010011000000000000000111111
 100100010000000010101000010001100100011110000110001100000000010000110001010001000000000010000111110001000111110000000000000000000001
 1000000100000000100010100100001101000011100011000011000000100000001100001000111111111000100001111000011000100000000000000000000000001
 111100011111111110011010010000011100100010011000001111100000000011100001000110000110000010000000000000000100000000000000000000111111
    1110000000000000100000100000011001100000111111111111000000001110000000111000000000000000000111111000001001100000000111111111
      1110000011100010000011111101100011001000000001100000001111111111100000000110000111000000010000100000000011000000000001
        11110000000000000000000000100000001000000001100000000000000000000000000100000100000000000000000000000001100000011111
           1111111111111111111111111111111111111111111111111111111111111111111111111111111111111111111111111111111111111
                                        111000001000000100000000000000000000000000000000000000000000100000000000011
                                    1111000000001000000100111111011111111111110000111111000000000000100000111111111
                                    1111100000001011111100100001010000010000010011100001000000000000000000000000001111
                                     11111100000000000000010000101000001000001000010000000000111111111110011000001111
                                         11000001000000000100000000000010000000000100001000001010000000000101000011
                                          111111111111111111111111111111111110000010000100000100100000000100011111
                                                                            1111001000010000010001000111100001
                                                                               1111111100000010000100001000001
                                                                                      111100010000010001000111
                                                                                          100100000100010001
                                                                                          111110000100010001
                                                                                              11000000000011
                                                                                               111110000011
                                                                                                   1111111
