R 1024 768
NO ../textures/moonn.xpm
SO ../textures/moons.xpm
WE ../textures/moonw.xpm
EA ../textures/moone.xpm

S ../textures/zil.xpm
F 244,128,20,23
C ../textures/space.xpm

11111111111111111111111111111111111111111111111111111111111111111111111111
10000000000000000000000000000000000000000000000000000000000000000000000001
1011111100N0011111111111111111111111111111111111111111111111111111111111111
101111111111111
101
101     1111111111111111111111111
101     1000000000110000000000001
1011    1011000001110000000000001
101     1001000000000000000000001
101111111011000001110000000000001
100000000011000001110111111111111
1111011111110101110000001000111111111111111111111111111111111111111111111
1111011111110101110101001000000000000000000000000000000000000000000000001
1100000000000000000000000000000000000000000000000000000000000000000000001
1000000000000000000000000000000000000000000000000000000000000000000000001
1000000000000000000000000000000000000000000000000000000000000000000000001
1000000000000000000000000000000000000000000000000000000000000000000000001
1000000000000000000000000000000000000000000000000000000000000000000000001
1000000111111110000000000000000000000000000000000000000000000000000000001
10000001      10000000000000000000000000000000000000000000000000000000001
1000000111111110000000000000000000000000000000000000000000000000000000001
1000000000000000000000000000000000000000000000000000000000000000000000001
1000000000000000000000000000000000000000000000000000000000000000000000001
1000022000000220000000220000111111111111111111111111111111111111111111111
10000000000000001101010010001
110000011101010111110111100111
11110111 1110101 101111010001
11111111 1111111 111111111111
