R 768 768
NXT ./zerg.cub

NO ../textures/tn.xpm
SO ../textures/ts.xpm
WE ../textures/tw.xpm
EA ../textures/te.xpm

S ../textures/tmarin.xpm ../textures/c14rifle2562.xpm ../textures/medic.xpm ../textures/bullets.xpm ../textures/tscv.xpm ../textures/tghost.xpm  ../textures/tdrop.xpm ../textures/riflehud1.xpm 
F ../textures/tfloor.xpm
C ../textures/tceil.xpm

                            11111111111111111111
                          1110000000000000000001
                          1000000000000000000111
						  10000000000000000001
						  10000000000000000001
                          10000000000000000001
                          10000000000000000011
                          1000000000000000011
                          100000000000000011       1
						  101111111111111111
						  101
1111111111111111111111111110111111111111111111111111111111111111111111111111111111111
1000000000000000000000000000000000000000000000000000000000000000000000000000000000001
1011111111111111111111111111111111111111111111111111011111111111111111111111111111111
10000001                                           101
1000001                                            101
1000001 1111111111111111111111111                111011111111111111
1011111 1000000000110000000000001                100000000000000001
1011    10110000011100000000000011111111         100000000000000011
101     10010000000000000000000000000001         100000000000111111
1011111110110000011100000000000011111111         1011111111111
100000000011000001110111111111111                101
11110111111101011100000010001111111111111111111111011111111111111111111111111111111111111
11110111111101011101010010000000000000000000000000000000000000000000000000000000000000001
11000000000000000000000000000000000000000000000000000000000000000000000011111111111111111
1000000000000000000000000000000000000000000000000000000000000000000000001
1000000000000000000000000000000000000000000000000000001111111111111111111
1000000000000000000000000000000000000111111111111110001
1000000000000000000000000000000000000111111111111110001111111111111111111
1000000111111110000000000000000000000000000000000000000000000000000000001
10000001      10000000000000000000000000000000000000000000000000000000001
1000000111111110000000000000000000000000000000000000000000000000000000001
1000000000000000000000000000000000000000000000000000000000000000000000001
1000000000000000000000000000000000000000000000000000000000000000000000001
1000000000000000000000000000111111111111111111111111111111111111111111111
10000000000000001101010010001
11000001110101011111011110011
11110111 1110101 101111010001
11111111 1111111 111111111111
